10 10
SCHCPHCHCC
CCHCCCHCHC
CHCHCHNNCH
HCCHCCHCCC
CHCHCCHCHP
CHCHHCHCHH
DCCCCHCCCC
CNNNCCCHCC
PCCCCCCHCC
CCCCCHCCCC