10 10
SCHNPHCHNC
CCHCCCHCHC
CHCHCHCHCH
HCNHCNHCNN
CHCHCCHCHP
CHCHHCHCHH
DCCCCHCCCC
NNNNCCCHCC
PCCCCCCHCC
NNCCCHCCCC