10 20 D
SCHCPHCHCCCCHCCCHCHC
CCHCCCHCHCCHCHCNPHCH
CHCHCHCHCHCCCCHCHCHH
HCCHCCHCCCCHCHCCHCHC
PHCHCCHCHPCCCCCCCCHC
CCCCHPHCHHCCCCCHCCPC
DCNNNNNCCCCCCNCCCHCC
CCCCCCCHCCCCNNNCCHCC
PCCCCCCHCCCCCCCHCCCC
CCCNCHCCPCNCCCHPHCHC