10 12 D
CCCCCCCCCCCC
CNCCCCCCCCCC
CCNCCCCCCCCC
CCCNCCCCCCCC
CCCCNCCCCCCC
CCCCCCCCCCCC
CCCCPCCNCCCC
CCCCDCCCNCCC
CCCCCCCCCNCC
CCCCCCCCCCCC