10 12 D
CCCCCCCCCCCC
CCCCCNCCCCCC
CNCCCCCCCCCC
CCCCNCCCCCCC
CCNCCCCCCCCC
CCCCCCCCCCCC
CCCCPCCCNNCC
CCCCDCCCCCCC
CCCCCCCCCCCC
CCCCCCCCCCCC