10 20 D
SCHNPHCHNCCCHCCCHCHC
CCHCCCHCHCCHCHCHPHCH
CHCHCHCHCHNNNNHCHCHH
HCNHCNHCNNCHCHCCHCHC
PHCHCCHCHPNNNNCCCHCC
NNNNHPHCHHNNCCCHCCPC
DCCCCHCCCCCCCCCCCHCC
NNNNCCCHCCNNNNCCCHCC
PCCCCCCHCCNNCCCHCCCC
NNCCCHCCPCNNNNHPHCHC