10 20 D
SCHCPHCHCCCCHCCCHCHC
CCHCCCHCHCCHCHNNNHCH
CHCHCHCHCHCCCCHCHCHH
HCCHCCHCCCCHCHCCHCHC
PHCHCCHCHPCCCCCCCCHC
CCCCHPHCHHCCCCCHCCPC
DCNNNNNCCCCCCCCCCHCC
CCCCCCCHCCCCCCCCCHCC
PCCCCCCHCCCCCCCHCCCC
CCCCCHCCPCCCCCHPHCHC