14  6  4  2 12  8  8  3 13 13 11  1 
 6  6  4  2 12 -1  8  3 13 13 11  1 
 9 -1  4  2 12 12  8  3 13 13 11  1 
 9  4  4  2 -1 12  8  3 13 13 11  1 
10  4 -1  2  2 12  8  3 13 13 11  1 
10  4  5  5  2 12  8  3 13 13 11  1 
10  4  5  5  2 12  8  3 -1 -1 11  1 
 7  4  5  5  2 12  8  3 15 15 11  1 
 7  4  5  5  2 12  8  3 15 15 11  1 
 7  4  5  5  2 12  8  3 15 15 11  1 
