 15    6   17    8   13   13   10    5    9    9   (1)   2  
  6    6   17    8   13   -1   10    5    9   (9)   1    2  
 17   -1   17    8   13   13   10    5    9    9    1    2  
 17   17   17    8   -1   13   10    5    9    9    1    2  
  4    4   -1    8    8   13   10    5    9    9    1    2  
 11    4   14   14    8   13   10    5    9    9    1   {2} 
 11    4   14   14    8   13   10    5   -1   -1    1    3  
 11    4   14   14    8   13   10    5   16   16    1    3  
  7    4   14   14    8   13   10    5   16   16    1   12  
 (7)   4   14  [14]   8   13   10    5   16   16    1   12  
