 2  1 10 10 10 10 13 13  3  5  5  5 
 2  1  1  1  1 -1 13 13  3  3  3  3 
 2 -1  7  7  1  1  1  1  1  1  1  1 
 2  7  7  7 -1  4  4  4  4  4  4  4 
 2  7 -1  7  7  4  6  6  8  8  8  8 
 2  7  9  9  7  4  6  6  8  8  8  8 
 2  7  9  9  7  4  6  6 -1 -1 11 11 
 2  7  9  9  7  4  6  6 14 14 11 12 
 2  7  9  9  7  4  6  6 14 14 11 12 
 2  7  9  9  7  4  6  6 14 14 11 12 
